10,10,10,10,35,0,33,10,10,10
10,10,10,10,9,0,33,10,10,10
1,42,42,42,43,0,41,42,42,3
9,0,7,0,0,0,12,0,0,11
43,0,23,0,0,0,0,0,0,41
0,0,0,0,12,0,0,13,0,0
27,0,0,0,0,0,0,0,0,25
9,0,0,4,5,5,6,0,0,11
9,0,0,0,0,0,0,0,0,11
17,18,18,26,26,26,26,18,18,19
