0,0,0,0,0,0,0,0,0,0
0,0,0,0,0,0,0,0,0,0
0,0,0,0,0,0,0,0,0,0
0,0,0,7,0,7,0,0,0,0
0,0,0,15,14,15,0,0,0,0
0,0,0,23,12,23,0,0,0,0
0,0,0,0,0,0,0,0,0,0
0,0,0,0,0,0,0,0,0,0
0,0,0,0,0,0,0,0,0,0
18,18,18,18,18,18,18,18,18,18
