1,2,2,2,2,2,2,2,2,3
9,0,0,0,0,0,0,0,0,11
9,0,0,0,0,0,0,0,0,11
9,0,25,26,27,0,0,0,0,11
9,0,41,42,43,0,0,0,0,41
9,0,0,0,0,0,0,0,0,0
9,0,0,0,0,0,0,0,0,25
9,0,0,4,5,5,5,6,0,11
9,0,0,0,0,0,0,0,0,11
17,18,18,18,18,18,18,18,18,19
