10,10,10,10,10,10,10,10,10,10
10,10,10,10,10,10,10,10,10,10
1,2,2,2,2,2,2,2,2,3
9,0,7,0,0,0,12,0,0,11
43,0,23,0,0,0,0,0,0,41
0,0,0,0,12,0,0,13,0,0
27,0,0,0,0,0,0,0,0,25
17,18,18,18,18,18,18,18,18,19
10,10,10,10,10,10,10,10,10,10
10,10,10,10,10,10,10,10,10,10
