1,2,2,2,43,0,41,2,2,3
9,0,0,12,0,0,0,0,0,11
9,0,0,12,0,0,0,0,0,11
9,0,12,12,0,0,0,0,0,11
9,0,0,12,0,0,0,0,0,11
9,0,0,0,0,0,12,0,0,11
9,0,12,12,12,0,12,0,0,11
9,0,12,0,12,0,12,0,0,11
9,0,0,0,12,0,12,0,0,11
17,18,18,18,18,18,18,18,18,19
