1,2,2,2,43,0,41,2,2,3
9,0,0,0,0,0,0,0,0,11
9,0,0,0,0,0,0,0,0,11
9,0,0,0,0,0,0,0,0,11
9,0,0,0,0,0,0,0,0,11
9,7,0,7,0,0,0,0,0,11
9,15,14,15,0,0,0,0,0,11
9,23,12,23,0,0,0,0,0,11
9,0,0,0,0,0,0,0,0,11
17,18,18,18,18,18,18,18,18,19
