10,10,10,1,43,0,41,3,10,10
10,10,10,9,0,0,0,11,10,10
10,10,10,9,0,0,0,11,10,10
10,10,10,9,0,0,12,11,10,10
10,10,10,9,0,0,0,11,10,10
10,10,10,9,12,0,0,11,10,10
10,10,10,9,0,0,0,11,10,10
10,10,10,9,0,0,0,11,10,10
10,10,10,9,0,0,0,11,10,10
10,10,10,17,27,0,25,19,10,10
