1,2,2,2,2,2,2,2,2,3
9,0,0,0,0,0,0,0,0,11
9,0,0,0,12,0,0,0,0,11
9,0,0,0,13,0,0,0,0,11
43,0,0,0,12,0,0,0,0,11
0,0,0,0,13,0,0,0,0,11
27,0,0,0,12,0,0,0,0,11
9,0,0,0,13,0,0,0,0,11
9,0,0,0,0,0,0,0,0,11
17,18,18,18,18,18,18,18,18,19
