1,2,2,2,42,42,42,42,2,3
9,0,0,0,0,0,0,0,0,11
9,0,12,0,0,0,0,0,0,11
9,0,0,12,0,0,12,0,0,11
43,0,0,0,0,0,0,0,0,41
0,0,12,0,12,0,0,0,0,0
27,0,0,0,0,0,0,0,0,25
9,0,12,0,0,0,12,0,0,11
9,0,0,0,0,0,0,0,0,11
17,18,18,18,27,0,25,18,18,19
