0,0,0,0,0,0,0,0,0,0
0,0,0,0,0,0,0,0,0,0
0,0,0,0,0,0,0,0,0,0
0,0,0,27,60,27,0,0,0,0
0,0,0,27,0,27,0,0,0,0
0,0,0,27,0,27,0,0,0,0
0,0,0,27,14,27,0,0,0,0
0,0,0,27,35,27,0,0,0,0
0,0,0,0,0,0,0,0,0,0
18,18,18,18,18,18,18,18,18,18
