1,2,2,2,43,0,41,3,10,10
9,0,0,0,0,0,0,11,10,10
9,0,0,13,0,0,0,11,10,10
9,0,7,0,0,0,12,11,10,10
43,0,23,0,0,0,0,11,10,10
0,0,0,0,0,0,0,11,10,10
27,0,0,0,0,0,0,11,10,10
9,0,0,0,0,0,0,11,10,10
9,0,0,0,0,0,0,11,10,10
17,18,18,18,27,0,25,19,10,10
