6,6,6,6,6,6,6,6,6,6
6,6,6,6,6,6,6,6,6,6
6,6,6,6,6,6,6,6,6,6
6,6,6,6,6,6,6,6,6,6
6,6,0,4,4,4,4,1,6,6
6,6,2,5,5,5,7,3,6,6
6,6,6,6,6,6,6,6,6,6
6,6,6,6,6,6,6,6,6,6
6,6,6,6,6,6,6,6,6,6
6,6,6,6,6,6,6,6,6,6