9,9,9,9,9,9,9,9,9,9
9,9,9,9,9,9,9,9,9,9
9,9,11,9,9,9,9,9,9,9
9,9,2,17,17,4,13,9,9,9
9,9,15,9,9,16,9,9,9,9
9,9,14,4,17,3,9,9,9,9
9,9,9,5,9,15,9,9,9,9
9,9,9,9,9,9,9,9,9,9
9,9,9,9,9,9,9,9,9,9
9,9,9,9,9,9,9,9,9,9