{
  "room_layout": [
    256,256,256,256,256,256,256,256,256,256,
    256,256,256,256,20,256,256,256,256,256,
    256,256,256,256,256,256,256,256,256,256,
    256,256,256,28,28,28,256,256,256,256,
    256,20,256,28,44,28,256,20,256,256,
    256,256,256,28,28,28,256,256,256,256,
    256,256,256,256,256,256,256,256,256,256,
    256,256,256,256,20,256,256,256,256,256,
    256,256,256,256,256,256,256,256,256,256,
    256,256,256,256,256,256,256,256,256,256
    ]
}
